##########
#.#......#
#.####.###
#......#.#
###.###.##
#....##.##
#.##..##..
#..##....#
#..####.##
##########